MCode,Cohort,AcademicYearStart,Women3,Men3,Cap,institution,Students3
Inf-NumProg,3,2022,0,6,,CAU_Germany,6
Inf-NNDL,3,2022,6,111,,CAU_Germany,117
inf-EnlOpt,3,2022,3,24,,CAU_Germany,27
inf-EAeS,3,2022,9,30,,CAU_Germany,39
Inf-GraphDraw,3,2022,0,15,,CAU_Germany,15
inf-TM,3,2022,9,33,,CAU_Germany,42
inf-AuLearn,3,2022,6,24,,CAU_Germany,30
inf-CI,3,2022,9,33,,CAU_Germany,42
Inf-DigSig,3,2022,3,24,,CAU_Germany,27
inf-IoT,3,2022,6,48,,CAU_Germany,54
Inf-CombWords,3,2022,9,24,,CAU_Germany,33
WInf-eBeM,3,2022,6,45,,CAU_Germany,51
inf-EERP,3,2022,15,51,,CAU_Germany,66
COMP3421,3,2022,6,0,10,Durham_England,6
COMP3467,3,2020,12,78,,Durham_England,90
COMP3467,3,2021,6,30,,Durham_England,36
COMP3477,3,2022,27,69,,Durham_England,96
COMP3477,3,2020,15,96,,Durham_England,111
COMP3477,3,2021,6,54,,Durham_England,60
COMP3487,3,2022,21,39,,Durham_England,60
COMP3487,3,2020,15,69,,Durham_England,84
COMP3487,3,2021,9,39,,Durham_England,48
COMP3491,3,2022,18,30,,Durham_England,48
COMP3491,3,2020,18,105,,Durham_England,123
COMP3491,3,2021,3,42,,Durham_England,45
COMP3507,3,2020,3,33,,Durham_England,36
COMP3507,3,2021,0,15,,Durham_England,15
COMP3517,3,2022,27,45,,Durham_England,72
COMP3517,3,2020,21,66,,Durham_England,87
COMP3517,3,2021,6,30,,Durham_England,36
COMP3527,3,2022,21,63,,Durham_England,84
COMP3527,3,2020,15,90,,Durham_England,105
COMP3527,3,2021,3,33,,Durham_England,36
COMP3547,3,2020,24,123,,Durham_England,147
COMP3547,3,2021,9,69,,Durham_England,78
COMP3547,3,2022,36,102,,Durham_England,138
COMP3557,3,2022,12,33,,Durham_England,45
COMP3557,3,2020,12,63,,Durham_England,75
COMP3557,3,2021,3,30,,Durham_England,33
COMP3567,3,2022,15,45,,Durham_England,60
COMP3567,3,2020,12,84,,Durham_England,96
COMP3567,3,2021,3,39,,Durham_England,42
COMP3577,3,2022,15,33,,Durham_England,48
COMP3577,3,2020,12,69,,Durham_England,81
COMP3577,3,2021,3,36,,Durham_England,39
COMP3587,3,2022,15,21,,Durham_England,36
COMP3587,3,2021,3,15,,Durham_England,18
COMP3607,3,2022,27,75,,Durham_England,102
COMP3607,3,2020,18,105,,Durham_England,123
COMP3607,3,2021,9,45,,Durham_England,54
COMP3617,3,2022,18,66,,Durham_England,84
COMP3617,3,2020,9,69,,Durham_England,78
COMP3617,3,2021,3,36,,Durham_England,39
COMP3621,3,2020,3,6,10,Durham_England,9
COMP3621,3,2021,3,3,10,Durham_England,6
COMP3647,3,2021,6,30,,Durham_England,36
COMP3647,3,2022,24,48,,Durham_England,72
COMP3657,3,2021,6,39,,Durham_England,45
COMP3657,3,2022,27,57,,Durham_England,84
COMP3667,3,2022,21,84,,Durham_England,105
COMP3677,3,2022,12,54,,Durham_England,66
COMP4087,4,2022,0,9,,Durham_England,9
COMP4087,4,2020,0,12,,Durham_England,12
COMP4087,4,2021,3,12,,Durham_England,15
COMP4097,4,2022,0,12,,Durham_England,12
COMP4097,4,2020,3,21,,Durham_England,24
COMP4097,4,2021,3,36,,Durham_England,39
COMP4107,4,2022,3,12,,Durham_England,15
COMP4107,4,2020,6,21,,Durham_England,27
COMP4107,4,2021,6,42,,Durham_England,48
COMP4117,4,2022,0,15,,Durham_England,15
COMP4117,4,2021,6,45,,Durham_England,51
COMP4127,4,2020,0,12,,Durham_England,12
COMP4137,4,2022,0,15,,Durham_England,15
COMP4137,4,2020,6,30,,Durham_England,36
COMP4137,4,2021,6,45,,Durham_England,51
COMP4157,4,2022,0,15,,Durham_England,15
COMP4157,4,2020,6,18,,Durham_England,24
COMP4157,4,2021,6,21,,Durham_England,27
COMP4167,4,2022,3,21,,Durham_England,24
COMP4167,4,2020,6,33,,Durham_England,39
COMP4167,4,2021,9,54,,Durham_England,63
COMP4177,4,2022,3,21,,Durham_England,24
COMP4177,4,2020,6,24,,Durham_England,30
COMP4177,4,2021,6,45,,Durham_England,51
COMP4187,4,2022,0,3,,Durham_England,3
COMP4187,4,2020,0,12,,Durham_England,12
COMP4187,4,2021,0,18,,Durham_England,18
COMP4197,4,2022,3,15,,Durham_England,18
COMP4197,4,2020,3,21,,Durham_England,24
COMP4197,4,2021,3,21,,Durham_England,24
cxinfr09042,3/4/5/,2020,18,42,,Edinburgh_Scotland,60
cxinfr09042,3/4/5/,2021,3,9,,Edinburgh_Scotland,12
cxinfr10052,3/4/5/,2020,9,48,,Edinburgh_Scotland,57
cxinfr10052,3/4/5/,2021,6,21,,Edinburgh_Scotland,27
cxinfr10052,3/4/5/,2022,6,30,,Edinburgh_Scotland,36
cxinfr10054,3/4/5/,2021,18,21,,Edinburgh_Scotland,39
cxinfr10054,3/4/5/,2022,9,12,,Edinburgh_Scotland,21
cxinfr10057,3/4/5/,2020,39,87,,Edinburgh_Scotland,126
cxinfr10057,3/4/5/,2021,36,90,,Edinburgh_Scotland,126
cxinfr10057,3/4/5/,2022,30,81,,Edinburgh_Scotland,111
cxinfr10059,3/4/5/,2021,12,24,,Edinburgh_Scotland,36
cxinfr10059,3/4/5/,2022,3,9,,Edinburgh_Scotland,12
cxinfr10061,3/4/5/,2022,3,21,,Edinburgh_Scotland,24
cxinfr10064,3/4/5/,2021,24,48,100,Edinburgh_Scotland,72
cxinfr10064,3/4/5/,2022,21,63,100,Edinburgh_Scotland,84
cxinfr10065,3/4/5/,2021,9,54,,Edinburgh_Scotland,63
cxinfr10065,3/4/5/,2022,21,114,,Edinburgh_Scotland,135
cxinfr10069,3/4/5/,2020,54,159,,Edinburgh_Scotland,213
cxinfr10069,3/4/5/,2021,54,147,,Edinburgh_Scotland,201
cxinfr10074,3/4/5/,2020,36,126,,Edinburgh_Scotland,162
cxinfr10074,3/4/5/,2021,33,129,,Edinburgh_Scotland,162
cxinfr10074,3/4/5/,2022,45,132,,Edinburgh_Scotland,177
cxinfr10076,3/4/5/,2021,9,27,60,Edinburgh_Scotland,36
cxinfr10076,3/4/5/,2022,3,36,60,Edinburgh_Scotland,39
cxinfr10077,3/4/5/,2020,9,21,,Edinburgh_Scotland,30
cxinfr10077,3/4/5/,2021,6,15,,Edinburgh_Scotland,21
cxinfr10077,3/4/5/,2022,9,21,,Edinburgh_Scotland,30
cxinfr10078,3/4/5/,2021,48,96,,Edinburgh_Scotland,144
cxinfr10078,3/4/5/,2022,36,84,,Edinburgh_Scotland,120
cxinfr10079,3/4/5/,2020,33,96,,Edinburgh_Scotland,129
cxinfr10079,3/4/5/,2021,9,63,,Edinburgh_Scotland,72
cxinfr10079,3/4/5/,2022,39,105,,Edinburgh_Scotland,144
cxinfr10080,3/4/5/,2020,54,120,,Edinburgh_Scotland,174
cxinfr10080,3/4/5/,2021,39,87,,Edinburgh_Scotland,126
cxinfr10080,3/4/5/,2022,18,57,,Edinburgh_Scotland,75
cxinfr10085,3/4/5/,2022,12,60,,Edinburgh_Scotland,72
cxinfr10086,3/4/5/,2022,30,93,,Edinburgh_Scotland,123
cxinfr10087,3/4/5/,2022,0,9,,Edinburgh_Scotland,9
cxinfr11017,3/4/5/,2020,18,63,,Edinburgh_Scotland,81
cxinfr11017,3/4/5/,2021,24,42,,Edinburgh_Scotland,66
cxinfr11017,3/4/5/,2022,21,27,,Edinburgh_Scotland,48
cxinfr11020,3/4/5/,2020,9,54,,Edinburgh_Scotland,63
cxinfr11020,3/4/5/,2021,9,36,,Edinburgh_Scotland,45
cxinfr11021,3/4/5/,2021,9,33,,Edinburgh_Scotland,42
cxinfr11023,3/4/5/,2021,3,18,,Edinburgh_Scotland,21
cxinfr11033,3/4/5/,2020,3,9,,Edinburgh_Scotland,12
cxinfr11033,3/4/5/,2021,6,15,,Edinburgh_Scotland,21
cxinfr11088,3/4/5/,2021,12,45,,Edinburgh_Scotland,57
cxinfr11088,3/4/5/,2022,9,24,,Edinburgh_Scotland,33
cxinfr11092,3/4/5/,2020,3,6,,Edinburgh_Scotland,9
cxinfr11092,3/4/5/,2021,0,3,,Edinburgh_Scotland,3
cxinfr11098,3/4/5/,2021,9,15,,Edinburgh_Scotland,24
cxinfr11098,3/4/5/,2022,3,15,,Edinburgh_Scotland,18
cxinfr11099,3/4/5/,2020,3,27,,Edinburgh_Scotland,30
cxinfr11099,3/4/5/,2021,3,21,,Edinburgh_Scotland,24
cxinfr11114,3/4/5/,2022,3,24,,Edinburgh_Scotland,27
cxinfr11130,3/4/5/,2020,12,63,,Edinburgh_Scotland,75
cxinfr11130,3/4/5/,2021,15,51,,Edinburgh_Scotland,66
cxinfr11130,3/4/5/,2022,9,24,,Edinburgh_Scotland,33
cxinfr11131,3/4/5/,2020,6,24,,Edinburgh_Scotland,30
cxinfr11131,3/4/5/,2021,3,9,,Edinburgh_Scotland,12
cxinfr11132,3/4/5/,2020,12,72,,Edinburgh_Scotland,84
cxinfr11132,3/4/5/,2021,18,60,,Edinburgh_Scotland,78
cxinfr11134,3/4/5/,2021,3,3,,Edinburgh_Scotland,6
cxinfr11144,3/4/5/,2020,6,63,,Edinburgh_Scotland,69
cxinfr11144,3/4/5/,2021,9,42,,Edinburgh_Scotland,51
cxinfr11145,3/4/5/,2020,12,60,,Edinburgh_Scotland,72
cxinfr11145,3/4/5/,2021,21,66,,Edinburgh_Scotland,87
cxinfr11150,3/4/5/,2020,6,18,,Edinburgh_Scotland,24
cxinfr11150,3/4/5/,2021,6,21,,Edinburgh_Scotland,27
cxinfr11157,3/4/5/,2020,12,33,,Edinburgh_Scotland,45
cxinfr11157,3/4/5/,2021,3,12,,Edinburgh_Scotland,15
cxinfr11160,3/4/5/,2020,12,24,,Edinburgh_Scotland,36
cxinfr11160,3/4/5/,2021,15,39,,Edinburgh_Scotland,54
cxinfr11160,3/4/5/,2022,21,51,,Edinburgh_Scotland,72
cxinfr11161,3/4/5/,2020,9,51,,Edinburgh_Scotland,60
cxinfr11161,3/4/5/,2021,6,15,,Edinburgh_Scotland,21
cxinfr11161,3/4/5/,2022,3,24,,Edinburgh_Scotland,27
cxinfr11187,3/4/5/,2021,0,6,,Edinburgh_Scotland,6
cxinfr11199,3/4/5/,2020,9,45,,Edinburgh_Scotland,54
cxinfr11199,3/4/5/,2021,15,27,,Edinburgh_Scotland,42
cxinfr11201,3/4/5/,2022,0,3,,Edinburgh_Scotland,3
cxinfr11202,3/4/5/,2021,3,18,,Edinburgh_Scotland,21
cxinfr11208,3/4/5/,2021,12,18,,Edinburgh_Scotland,30
cxinfr11209,3/4/5/,2022,3,12,,Edinburgh_Scotland,15
cxinfr11213,3/4/5/,2022,3,15,44,Edinburgh_Scotland,18
cxinfr11217,3/4/5/,2022,9,30,,Edinburgh_Scotland,39
cxinfr11218,3/4/5/,2022,6,21,,Edinburgh_Scotland,27
cxinfr11219,3/4/5/,2022,9,15,,Edinburgh_Scotland,24
cxinfr11220,3/4/5/,2022,12,57,,Edinburgh_Scotland,69
cxinfr11221,3/4/5/,2022,6,9,,Edinburgh_Scotland,15
cxinfr11222,3/4/5/,2022,3,12,,Edinburgh_Scotland,15
cxinfr11223,3/4/5/,2022,18,66,,Edinburgh_Scotland,84
cxinfr11224,3/4/5/,2022,9,15,,Edinburgh_Scotland,24
cxinfr11225,3/4/5/,2022,9,21,,Edinburgh_Scotland,30
cxinfr11226,3/4/5/,2022,3,15,,Edinburgh_Scotland,18
cxinfr11227,3/4/5/,2022,3,6,,Edinburgh_Scotland,9
cxinfr11228,3/4/5/,2022,15,30,,Edinburgh_Scotland,45
cxinfr11229,3/4/5/,2022,6,42,,Edinburgh_Scotland,48
cxinfr11235,3/4/5/,2022,3,9,,Edinburgh_Scotland,12
cxinfr11238,3/4/5/,2022,18,75,,Edinburgh_Scotland,93
cxinfr11239,3/4/5/,2022,12,45,,Edinburgh_Scotland,57
COMPSCI4003,H,2020,9,39,,Glasgow_Scotland,48
COMPSCI4004,H,2020,27,84,,Glasgow_Scotland,111
COMPSCI4007,H,2020,0,21,,Glasgow_Scotland,21
COMPSCI4011,H,2020,15,81,,Glasgow_Scotland,96
COMPSCI4012,H,2020,24,126,,Glasgow_Scotland,150
COMPSCI4013,H,2020,45,144,,Glasgow_Scotland,189
COMPSCI4016,H,2020,27,102,,Glasgow_Scotland,129
COMPSCI4021,H,2020,15,120,,Glasgow_Scotland,135
COMPSCI4023,H,2020,18,69,,Glasgow_Scotland,87
COMPSCI4031,H,2020,0,6,,Glasgow_Scotland,6
COMPSCI4061,H,2020,15,60,,Glasgow_Scotland,75
COMPSCI4066,H,2020,12,36,,Glasgow_Scotland,48
COMPSCI4068,H,2020,45,105,,Glasgow_Scotland,150
COMPSCI4069,H,2020,6,18,,Glasgow_Scotland,24
COMPSCI4071,H,2020,6,33,,Glasgow_Scotland,39
COMPSCI4072,H,2020,3,15,,Glasgow_Scotland,18
COMPSCI4074,H,2020,15,69,,Glasgow_Scotland,84
COMPSCI4075,H,2020,12,30,,Glasgow_Scotland,42
COMPSCI4076,H,2020,18,78,,Glasgow_Scotland,96
COMPSCI4077,H,2020,24,78,,Glasgow_Scotland,102
COMPSCI4080,H,2020,15,27,,Glasgow_Scotland,42
COMPSCI4082,H,2020,0,21,,Glasgow_Scotland,21
COMPSCI4087,H,2020,24,99,,Glasgow_Scotland,123
COMPSCI4089,H,2020,0,15,,Glasgow_Scotland,15
COMPSCI4003,H,2021,30,63,,Glasgow_Scotland,93
COMPSCI4004,H,2021,42,153,,Glasgow_Scotland,195
COMPSCI4007,H,2021,21,81,,Glasgow_Scotland,102
COMPSCI4011,H,2021,18,72,,Glasgow_Scotland,90
COMPSCI4012,H,2021,27,90,,Glasgow_Scotland,117
COMPSCI4013,H,2021,39,135,,Glasgow_Scotland,174
COMPSCI4016,H,2021,27,132,,Glasgow_Scotland,159
COMPSCI4021,H,2021,30,102,,Glasgow_Scotland,132
COMPSCI4023,H,2021,24,81,,Glasgow_Scotland,105
COMPSCI4031,H,2021,6,21,,Glasgow_Scotland,27
COMPSCI4061,H,2021,33,114,,Glasgow_Scotland,147
COMPSCI4064,H,2021,0,12,,Glasgow_Scotland,12
COMPSCI4068,H,2021,54,150,,Glasgow_Scotland,204
COMPSCI4069,H,2021,15,42,,Glasgow_Scotland,57
COMPSCI4071,H,2021,6,39,,Glasgow_Scotland,45
COMPSCI4072,H,2021,3,9,,Glasgow_Scotland,12
COMPSCI4074,H,2021,27,78,,Glasgow_Scotland,105
COMPSCI4075,H,2021,15,57,,Glasgow_Scotland,72
COMPSCI4076,H,2021,39,150,,Glasgow_Scotland,189
COMPSCI4077,H,2021,9,33,,Glasgow_Scotland,42
COMPSCI4080,H,2021,21,57,,Glasgow_Scotland,78
COMPSCI4087,H,2021,18,69,,Glasgow_Scotland,87
COMPSCI4089,H,2021,9,36,,Glasgow_Scotland,45
COMPSCI4091,H,2021,6,24,,Glasgow_Scotland,30
COMPSCI4003,H,2022,9,42,,Glasgow_Scotland,51
COMPSCI4004,H,2022,9,60,,Glasgow_Scotland,69
COMPSCI4007,H,2022,3,30,,Glasgow_Scotland,33
COMPSCI4011,H,2022,12,66,,Glasgow_Scotland,78
COMPSCI4012,H,2022,27,108,,Glasgow_Scotland,135
COMPSCI4013,H,2022,48,183,,Glasgow_Scotland,231
COMPSCI4016,H,2022,27,126,,Glasgow_Scotland,153
COMPSCI4021,H,2022,21,111,,Glasgow_Scotland,132
COMPSCI4023,H,2022,24,69,,Glasgow_Scotland,93
COMPSCI4031,H,2022,3,12,,Glasgow_Scotland,15
COMPSCI4061,H,2022,18,75,,Glasgow_Scotland,93
COMPSCI4064,H,2022,3,15,,Glasgow_Scotland,18
COMPSCI4066,H,2022,15,39,,Glasgow_Scotland,54
COMPSCI4068,H,2022,51,126,,Glasgow_Scotland,177
COMPSCI4069,H,2022,9,36,,Glasgow_Scotland,45
COMPSCI4071,H,2022,3,33,,Glasgow_Scotland,36
COMPSCI4072,H,2022,6,21,,Glasgow_Scotland,27
COMPSCI4074,H,2022,27,108,,Glasgow_Scotland,135
COMPSCI4075,H,2022,15,60,,Glasgow_Scotland,75
COMPSCI4076,H,2022,18,105,,Glasgow_Scotland,123
COMPSCI4077,H,2022,6,21,,Glasgow_Scotland,27
COMPSCI4080,H,2022,18,39,,Glasgow_Scotland,57
COMPSCI4082,H,2022,6,30,,Glasgow_Scotland,36
COMPSCI4087,H,2022,24,63,,Glasgow_Scotland,87
COMPSCI4089,H,2022,6,24,,Glasgow_Scotland,30
COMPSCI4091,H,2022,6,18,,Glasgow_Scotland,24
IT4733,1,2020,3,0,,Kennesaw_USA,3
IT4793,1,2021,3,0,,Kennesaw_USA,3
IT4733,1,2022,9,6,,Kennesaw_USA,15
IT4773,1,2022,6,3,,Kennesaw_USA,9
IT4533,1,2020,6,3,,Kennesaw_USA,9
IT4773,1,2021,3,3,,Kennesaw_USA,6
IT4513,1,2020,6,6,,Kennesaw_USA,12
IT4523,1,2020,6,6,,Kennesaw_USA,12
IT4713,1,2022,6,6,,Kennesaw_USA,12
IT3503,1,2020,33,39,,Kennesaw_USA,72
IT3503,1,2022,27,33,,Kennesaw_USA,60
CS4626,1,2021,3,3,,Kennesaw_USA,6
IT3703,1,2020,9,12,,Kennesaw_USA,21
IT3703,1,2021,12,18,,Kennesaw_USA,30
CYBR3305,1,2021,21,30,,Kennesaw_USA,51
IT4603,1,2021,3,6,,Kennesaw_USA,9
CYBR4305,1,2020,9,18,,Kennesaw_USA,27
IT3503,1,2021,24,39,,Kennesaw_USA,63
CYBR4350,1,2022,9,15,,Kennesaw_USA,24
IT4893,1,2021,6,9,,Kennesaw_USA,15
CS4422,1,2022,9,15,,Kennesaw_USA,24
CYBR4893,1,2020,6,15,,Kennesaw_USA,21
CSE4983,1,2020,12,27,,Kennesaw_USA,39
CS4524,1,2021,6,12,,Kennesaw_USA,18
CYBR4350,1,2021,12,27,,Kennesaw_USA,39
IT4863,1,2022,9,18,,Kennesaw_USA,27
CSE1300,1,2022,120,273,,Kennesaw_USA,393
CYBR3305,1,2020,18,39,,Kennesaw_USA,57
IT4203,1,2020,12,27,,Kennesaw_USA,39
CYBR4843,1,2020,12,33,,Kennesaw_USA,45
CYBR4305,1,2022,18,42,,Kennesaw_USA,60
SWE4783,1,2022,18,48,,Kennesaw_USA,66
CYBR4305,1,2021,12,30,,Kennesaw_USA,42
SWE4743,1,2022,6,15,,Kennesaw_USA,21
CSE4983,1,2021,18,48,,Kennesaw_USA,66
SWE4783,1,2021,18,51,,Kennesaw_USA,69
CYBR3153,1,2021,15,36,,Kennesaw_USA,51
CYBR4853,1,2022,21,57,,Kennesaw_USA,78
IT4893,1,2020,3,9,,Kennesaw_USA,12
IT4673,1,2021,9,24,,Kennesaw_USA,33
CYBR3305,1,2022,18,48,,Kennesaw_USA,66
IT4883,1,2022,15,45,,Kennesaw_USA,60
CSE1300,1,2021,132,384,,Kennesaw_USA,516
IT4843,1,2022,27,81,,Kennesaw_USA,108
IT3703,1,2022,3,12,,Kennesaw_USA,15
IT4153,1,2021,12,33,,Kennesaw_USA,45
IT4673,1,2022,6,21,,Kennesaw_USA,27
CSE1300,1,2020,111,342,,Kennesaw_USA,453
IT4713,1,2021,9,30,,Kennesaw_USA,39
CYBR4843,1,2021,18,60,,Kennesaw_USA,78
CYBR3223,1,2021,6,15,,Kennesaw_USA,21
SWE4633,1,2021,9,33,,Kennesaw_USA,42
CYBR4893,1,2022,12,42,,Kennesaw_USA,54
IT4853,1,2022,12,42,,Kennesaw_USA,54
CYBR3153,1,2020,15,54,,Kennesaw_USA,69
CS4622,1,2020,3,9,,Kennesaw_USA,12
CYBR3223,1,2022,9,27,,Kennesaw_USA,36
CSE3203,1,2021,6,18,,Kennesaw_USA,24
CYBR3223,1,2020,6,18,,Kennesaw_USA,24
CYBR4883,1,2022,6,18,,Kennesaw_USA,24
IT4833,1,2020,24,84,,Kennesaw_USA,108
CYBR4853,1,2021,9,30,,Kennesaw_USA,39
IT4713,1,2020,12,45,,Kennesaw_USA,57
IT4853,1,2020,24,87,,Kennesaw_USA,111
CGDD4113,1,2022,3,15,,Kennesaw_USA,18
IT4893,1,2022,3,15,,Kennesaw_USA,18
CS4720,1,2021,9,33,,Kennesaw_USA,42
IT4853,1,2021,27,96,,Kennesaw_USA,123
CS4622,1,2022,6,24,,Kennesaw_USA,30
SWE4783,1,2020,12,48,,Kennesaw_USA,60
IT4403,1,2022,3,15,,Kennesaw_USA,18
IT4423,1,2022,3,15,,Kennesaw_USA,18
IT4843,1,2021,21,75,,Kennesaw_USA,96
CSE4983,1,2022,9,33,,Kennesaw_USA,42
CYBR4833,1,2022,15,54,,Kennesaw_USA,69
IT4833,1,2022,15,60,,Kennesaw_USA,75
IT4423,1,2020,45,168,,Kennesaw_USA,213
CYBR4853,1,2020,15,54,,Kennesaw_USA,69
CGDD2012L,1,2022,24,99,,Kennesaw_USA,123
CS4422,1,2021,3,12,,Kennesaw_USA,15
IT4423,1,2021,24,96,,Kennesaw_USA,120
IT4843,1,2020,24,99,,Kennesaw_USA,123
IT4153,1,2022,6,21,,Kennesaw_USA,27
CGDD4603,1,2021,3,18,,Kennesaw_USA,21
CS3626,1,2021,21,84,,Kennesaw_USA,105
IT4863,1,2021,3,18,,Kennesaw_USA,21
CS4265,1,2022,6,30,,Kennesaw_USA,36
IT4883,1,2020,15,60,,Kennesaw_USA,75
CYBR4333,1,2022,9,42,,Kennesaw_USA,51
CYBR4843,1,2022,12,57,,Kennesaw_USA,69
CGDD4113,1,2020,6,27,,Kennesaw_USA,33
CS4720,1,2020,39,174,,Kennesaw_USA,213
IT4123,1,2020,36,153,,Kennesaw_USA,189
CS4265,1,2020,9,36,,Kennesaw_USA,45
CYBR4350,1,2020,3,18,,Kennesaw_USA,21
CGDD4603,1,2022,3,15,,Kennesaw_USA,18
CS4626,1,2022,3,15,,Kennesaw_USA,18
CS4732,1,2020,3,15,,Kennesaw_USA,18
SWE4633,1,2020,6,33,,Kennesaw_USA,39
CYBR4833,1,2021,9,39,,Kennesaw_USA,48
SWE4743,1,2020,3,18,,Kennesaw_USA,21
IT4203,1,2021,6,24,,Kennesaw_USA,30
CSE3203,1,2020,6,30,,Kennesaw_USA,36
CS4712,1,2020,18,90,,Kennesaw_USA,108
CYBR4333,1,2021,9,51,,Kennesaw_USA,60
CYBR4893,1,2021,9,45,,Kennesaw_USA,54
IT4333,1,2021,12,63,,Kennesaw_USA,75
CS4612,1,2022,6,27,,Kennesaw_USA,33
IT4403,1,2021,3,15,,Kennesaw_USA,18
CS3626,1,2022,27,150,,Kennesaw_USA,177
CGDD4113,1,2021,6,33,,Kennesaw_USA,39
CS4412,1,2021,12,72,,Kennesaw_USA,84
CS3626,1,2020,6,39,,Kennesaw_USA,45
CS4412,1,2022,6,39,,Kennesaw_USA,45
IT4833,1,2021,9,57,,Kennesaw_USA,66
CGDD4603,1,2020,3,18,,Kennesaw_USA,21
CS4524,1,2022,3,18,,Kennesaw_USA,21
CS4712,1,2022,6,33,,Kennesaw_USA,39
CYBR3153,1,2022,9,57,,Kennesaw_USA,66
CS4732,1,2021,3,24,,Kennesaw_USA,27
CS3642,1,2022,27,168,,Kennesaw_USA,195
CS3642,1,2021,30,189,,Kennesaw_USA,219
CS4524,1,2020,3,18,,Kennesaw_USA,21
CYBR4333,1,2020,3,18,,Kennesaw_USA,21
CS4412,1,2020,6,45,,Kennesaw_USA,51
CGDD2012L,1,2021,15,99,,Kennesaw_USA,114
IT4213,1,2020,3,21,,Kennesaw_USA,24
CS3642,1,2020,24,168,,Kennesaw_USA,192
CS4267,1,2021,6,48,,Kennesaw_USA,54
CGDD2012L,1,2020,12,87,,Kennesaw_USA,99
IT4883,1,2021,9,72,,Kennesaw_USA,81
IT4673,1,2020,3,30,,Kennesaw_USA,33
CYBR4833,1,2020,3,21,,Kennesaw_USA,24
IT4333,1,2020,6,45,,Kennesaw_USA,51
CS4712,1,2021,3,30,,Kennesaw_USA,33
IT4333,1,2022,3,33,,Kennesaw_USA,36
CS4265,1,2021,3,36,,Kennesaw_USA,39
CS4322,1,2022,6,45,,Kennesaw_USA,51
SWE4633,1,2022,3,27,,Kennesaw_USA,30
IT4153,1,2020,6,48,,Kennesaw_USA,54
CS4267,1,2020,3,30,,Kennesaw_USA,33
CS4267,1,2022,3,45,,Kennesaw_USA,48
CS4277,1,2021,0,6,,Kennesaw_USA,6
CS4277,1,2022,0,27,,Kennesaw_USA,27
CS4522,1,2020,0,3,,Kennesaw_USA,3
CS4522,1,2021,0,9,,Kennesaw_USA,9
CS4522,1,2022,0,18,,Kennesaw_USA,18
CS4622,1,2021,0,6,,Kennesaw_USA,6
CS4732,1,2022,0,33,,Kennesaw_USA,33
CS4742,1,2021,0,6,,Kennesaw_USA,6
CS4742,1,2022,0,18,,Kennesaw_USA,18
CYBR3220,1,2021,0,3,,Kennesaw_USA,3
CYBR3220,1,2022,0,3,,Kennesaw_USA,3
CYBR4700,1,2020,0,3,,Kennesaw_USA,3
CYBR4883,1,2020,0,12,,Kennesaw_USA,12
CYBR4883,1,2021,0,15,,Kennesaw_USA,15
IT4403,1,2020,0,12,,Kennesaw_USA,12
SWE3683,1,2020,0,9,,Kennesaw_USA,9
SWE4803,1,2021,0,3,,Kennesaw_USA,3
5.574,1,2020,9,123,,UOC_Spain,132
5.574,1,2021,12,120,,UOC_Spain,132
5.574,1,2022,9,144,,UOC_Spain,153
5.576,1,2020,9,81,,UOC_Spain,90
5.576,1,2021,12,111,,UOC_Spain,123
5.576,1,2022,15,117,,UOC_Spain,132
5.577,1,2020,3,42,,UOC_Spain,45
5.577,1,2021,3,51,,UOC_Spain,54
5.577,1,2022,6,51,,UOC_Spain,57
5.578,1,2020,3,30,,UOC_Spain,33
5.578,1,2021,3,42,,UOC_Spain,45
5.578,1,2022,9,45,,UOC_Spain,54
5.579,1,2020,3,90,,UOC_Spain,93
5.579,1,2021,12,111,,UOC_Spain,123
5.579,1,2022,15,96,,UOC_Spain,111
5.58,1,2020,6,72,,UOC_Spain,78
5.58,1,2021,9,87,,UOC_Spain,96
5.58,1,2022,12,99,,UOC_Spain,111
5.581,1,2020,18,90,,UOC_Spain,108
5.581,1,2021,21,126,,UOC_Spain,147
5.581,1,2022,12,129,,UOC_Spain,141
5.583,1,2020,12,102,,UOC_Spain,114
5.583,1,2021,18,126,,UOC_Spain,144
5.583,1,2022,15,132,,UOC_Spain,147
5.584,1,2020,24,198,,UOC_Spain,222
5.584,1,2021,21,210,,UOC_Spain,231
5.584,1,2022,18,225,,UOC_Spain,243
5.586,1,2020,24,156,,UOC_Spain,180
5.586,1,2021,24,216,,UOC_Spain,240
5.586,1,2022,30,228,,UOC_Spain,258
5.587,1,2020,15,108,,UOC_Spain,123
5.587,1,2021,18,144,,UOC_Spain,162
5.587,1,2022,18,165,,UOC_Spain,183
5.588,1,2020,9,54,,UOC_Spain,63
5.588,1,2021,15,90,,UOC_Spain,105
5.588,1,2022,9,96,,UOC_Spain,105
5.591,1,2020,6,66,,UOC_Spain,72
5.591,1,2021,6,66,,UOC_Spain,72
5.591,1,2022,6,66,,UOC_Spain,72
5.592,1,2020,3,30,,UOC_Spain,33
5.592,1,2021,3,33,,UOC_Spain,36
5.592,1,2022,6,36,,UOC_Spain,42
5.593,1,2020,18,141,,UOC_Spain,159
5.593,1,2021,24,183,,UOC_Spain,207
5.593,1,2022,27,264,,UOC_Spain,291
5.594,1,2020,3,48,,UOC_Spain,51
5.594,1,2021,3,57,,UOC_Spain,60
5.594,1,2022,3,66,,UOC_Spain,69
5.595,1,2020,6,102,,UOC_Spain,108
5.595,1,2021,15,105,,UOC_Spain,120
5.595,1,2022,15,123,,UOC_Spain,138
5.596,1,2020,15,153,,UOC_Spain,168
5.596,1,2021,27,195,,UOC_Spain,222
5.596,1,2022,30,201,,UOC_Spain,231
5.597,1,2020,24,189,,UOC_Spain,213
5.597,1,2021,18,204,,UOC_Spain,222
5.597,1,2022,21,240,,UOC_Spain,261
5.598,1,2020,12,93,,UOC_Spain,105
5.598,1,2021,9,129,,UOC_Spain,138
5.598,1,2022,18,138,,UOC_Spain,156
5.599,1,2020,12,126,,UOC_Spain,138
5.599,1,2021,15,138,,UOC_Spain,153
5.599,1,2022,18,171,,UOC_Spain,189
5.6,1,2020,9,96,,UOC_Spain,105
5.6,1,2021,15,117,,UOC_Spain,132
5.6,1,2022,15,141,,UOC_Spain,156
5.601,1,2020,15,81,,UOC_Spain,96
5.601,1,2021,9,90,,UOC_Spain,99
5.601,1,2022,12,108,,UOC_Spain,120
5.604,1,2020,12,144,,UOC_Spain,156
5.604,1,2021,21,204,,UOC_Spain,225
5.604,1,2022,24,222,,UOC_Spain,246
5.607,1,2020,12,126,,UOC_Spain,138
5.607,1,2021,12,126,,UOC_Spain,138
5.607,1,2022,21,159,,UOC_Spain,180
5.613,1,2020,15,144,,UOC_Spain,159
5.613,1,2021,27,198,,UOC_Spain,225
5.613,1,2022,54,339,,UOC_Spain,393
5.614,1,2020,114,756,,UOC_Spain,870
5.614,1,2021,126,747,,UOC_Spain,873
5.614,1,2022,126,801,,UOC_Spain,927
5.672,1,2020,3,18,,UOC_Spain,21
5.672,1,2021,6,27,,UOC_Spain,33
5.672,1,2022,3,27,,UOC_Spain,30
22.4,1,2022,42,123,,UOC_Spain,165
CSC301H5,3,2020,18,93,,UofT_Canada,111
CSC301H5,3,2021,9,129,,UofT_Canada,138
CSC301H5,3,2022,6,45,,UofT_Canada,51
CSC309H5,3,2020,12,111,,UofT_Canada,123
CSC309H5,3,2021,21,153,,UofT_Canada,174
CSC309H5,3,2022,18,126,,UofT_Canada,144
CSC311H5,3,2020,24,138,,UofT_Canada,162
CSC311H5,3,2021,27,153,,UofT_Canada,180
CSC311H5,3,2022,27,150,,UofT_Canada,177
CSC324H5,3,2020,27,99,,UofT_Canada,126
CSC324H5,3,2021,33,195,,UofT_Canada,228
CSC324H5,3,2022,15,81,,UofT_Canada,96
CSC338H5,3,2020,12,45,,UofT_Canada,57
CSC338H5,3,2021,9,45,,UofT_Canada,54
CSC338H5,3,2022,9,30,,UofT_Canada,39
CSC347H5,3,2020,18,126,,UofT_Canada,144
CSC347H5,3,2021,21,135,,UofT_Canada,156
CSC347H5,3,2022,18,111,,UofT_Canada,129
CSC367H5,3,2020,6,48,,UofT_Canada,54
CSC367H5,3,2021,6,54,,UofT_Canada,60
CSC367H5,3,2022,3,51,,UofT_Canada,54
CSC375H5,3,2020,0,15,,UofT_Canada,15
CSC375H5,3,2022,0,6,,UofT_Canada,6
CSC376H5,3,2020,3,24,,UofT_Canada,27
CSC376H5,3,2021,6,33,,UofT_Canada,39
CSC376H5,3,2022,3,39,,UofT_Canada,42
CSC384H5,3,2020,6,27,,UofT_Canada,33
CSC384H5,3,2021,9,57,,UofT_Canada,66
CSC384H5,3,2022,12,81,,UofT_Canada,93
CSC413H5,4,2020,12,54,,UofT_Canada,66
CSC413H5,4,2021,9,54,,UofT_Canada,63
CSC413H5,4,2022,9,63,,UofT_Canada,72
CSC488H5,4,2021,3,24,,UofT_Canada,27
CSC488H5,4,2022,3,36,,UofT_Canada,39
1DL481,1,2020,6,27,,Uppsala_Sweden,33
1MD001,1,2020,24,24,,Uppsala_Sweden,48
1TD169,1,2020,15,39,,Uppsala_Sweden,54
1TD388,1,2020,15,30,,Uppsala_Sweden,45
1TD062,1,2020,24,78,,Uppsala_Sweden,102
1DL034,1,2020,15,54,,Uppsala_Sweden,69
1MD004,1,2020,18,27,,Uppsala_Sweden,45
1DT075,1,2020,9,42,,Uppsala_Sweden,51
1DL550,1,2020,6,33,,Uppsala_Sweden,39
1DL251,1,2020,12,48,,Uppsala_Sweden,60
1MD300,1,2020,6,9,,Uppsala_Sweden,15
1DL481,1,2021,3,27,,Uppsala_Sweden,30
1MD001,1,2021,12,27,,Uppsala_Sweden,39
1TD169,1,2021,12,36,,Uppsala_Sweden,48
1TD388,1,2021,6,21,,Uppsala_Sweden,27
1TD062,1,2021,12,57,,Uppsala_Sweden,69
1DL034,1,2021,24,99,,Uppsala_Sweden,123
1MD004,1,2021,18,15,,Uppsala_Sweden,33
1DT075,1,2021,12,39,,Uppsala_Sweden,51
1DL550,1,2021,3,33,,Uppsala_Sweden,36
1DL251,1,2021,9,24,,Uppsala_Sweden,33
1MD300,1,2021,9,12,,Uppsala_Sweden,21
1DL481,1,2022,3,21,,Uppsala_Sweden,24
1MD001,1,2022,24,24,,Uppsala_Sweden,48
1TD169,1,2022,18,84,,Uppsala_Sweden,102
1TD388,1,2022,0,24,,Uppsala_Sweden,24
1TD062,1,2022,18,66,,Uppsala_Sweden,84
1DL034,1,2022,18,66,,Uppsala_Sweden,84
1MD004,1,2022,21,21,,Uppsala_Sweden,42
1DT075,1,2022,6,48,,Uppsala_Sweden,54
1DL550,1,2022,3,36,,Uppsala_Sweden,39
1DL251,1,2022,3,36,,Uppsala_Sweden,39
1MD300,1,2022,6,6,,Uppsala_Sweden,12
1DT052,1,2020,15,60,,Uppsala_Sweden,75
1TD403,1,2020,6,39,,Uppsala_Sweden,45
1DT072,1,2020,12,60,,Uppsala_Sweden,72
1DL251,1,2020,42,66,,Uppsala_Sweden,108
1DT052,1,2021,12,42,,Uppsala_Sweden,54
1TD403,1,2021,12,72,,Uppsala_Sweden,84
1DT072,1,2021,15,66,,Uppsala_Sweden,81
1DL251,1,2021,30,66,,Uppsala_Sweden,96
1DT052,1,2022,9,42,,Uppsala_Sweden,51
1TD403,1,2022,15,57,,Uppsala_Sweden,72
1DT072,1,2022,18,84,,Uppsala_Sweden,102
1DL251,1,2022,33,87,,Uppsala_Sweden,120
CS3704,1,2020,42,126,,VirginiaTech_USA,168
CS3704,1,2021,27,147,,VirginiaTech_USA,174
CS3704,1,2022,69,261,,VirginiaTech_USA,330
CS3714,1,2020,24,117,,VirginiaTech_USA,141
CS3714,1,2021,18,147,,VirginiaTech_USA,165
CS3714,1,2022,36,168,,VirginiaTech_USA,204
CS3724,1,2020,51,126,,VirginiaTech_USA,177
CS3724,1,2021,81,177,,VirginiaTech_USA,258
CS3724,1,2022,66,180,,VirginiaTech_USA,246
CS3744,1,2020,27,120,,VirginiaTech_USA,147
CS3744,1,2021,21,132,,VirginiaTech_USA,153
CS3744,1,2022,51,183,,VirginiaTech_USA,234
CS3754,1,2020,12,105,,VirginiaTech_USA,117
CS3754,1,2021,21,105,,VirginiaTech_USA,126
CS3754,1,2022,12,84,,VirginiaTech_USA,96
CS3824,1,2020,6,30,,VirginiaTech_USA,36
CS3824,1,2021,3,18,,VirginiaTech_USA,21
CS3824,1,2022,3,12,,VirginiaTech_USA,15
CS4104,1,2020,39,168,,VirginiaTech_USA,207
CS4104,1,2021,54,279,,VirginiaTech_USA,333
CS4104,1,2022,66,321,,VirginiaTech_USA,387
CS4114,1,2020,33,105,,VirginiaTech_USA,138
CS4114,1,2021,15,54,,VirginiaTech_USA,69
CS4114,1,2022,18,63,,VirginiaTech_USA,81
CS4124,1,2020,0,15,,VirginiaTech_USA,15
CS4124,1,2021,0,12,,VirginiaTech_USA,12
CS4124,1,2022,3,42,,VirginiaTech_USA,45
CS4134,1,2020,3,30,,VirginiaTech_USA,33
CS4144,1,2020,0,6,,VirginiaTech_USA,6
CS4234,1,2020,0,12,,VirginiaTech_USA,12
CS4234,1,2021,3,9,,VirginiaTech_USA,12
CS4234,1,2022,3,15,,VirginiaTech_USA,18
CS4254,1,2020,3,21,,VirginiaTech_USA,24
CS4254,1,2021,6,27,,VirginiaTech_USA,33
CS4254,1,2022,3,42,,VirginiaTech_USA,45
CS4264,1,2020,24,108,,VirginiaTech_USA,132
CS4264,1,2021,12,96,,VirginiaTech_USA,108
CS4264,1,2022,21,135,,VirginiaTech_USA,156
CS4284,1,2020,9,48,,VirginiaTech_USA,57
CS4284,1,2021,6,27,,VirginiaTech_USA,33
CS4284,1,2022,6,39,,VirginiaTech_USA,45
CS4504,1,2020,0,9,,VirginiaTech_USA,9
CS4504,1,2021,0,9,,VirginiaTech_USA,9
CS4504,1,2022,3,9,,VirginiaTech_USA,12
CS4604,1,2020,6,63,,VirginiaTech_USA,69
CS4604,1,2021,18,63,,VirginiaTech_USA,81
CS4604,1,2022,36,102,,VirginiaTech_USA,138
CS4624,1,2020,9,54,,VirginiaTech_USA,63
CS4624,1,2021,12,117,,VirginiaTech_USA,129
CS4624,1,2022,30,123,,VirginiaTech_USA,153
CS4644,1,2020,18,39,,VirginiaTech_USA,57
CS4644,1,2021,15,21,,VirginiaTech_USA,36
CS4644,1,2022,18,21,,VirginiaTech_USA,39
CS4704,1,2020,30,117,,VirginiaTech_USA,147
CS4704,1,2021,21,132,,VirginiaTech_USA,153
CS4704,1,2022,30,186,,VirginiaTech_USA,216
CS4784,1,2020,12,24,,VirginiaTech_USA,36
CS4784,1,2021,18,27,,VirginiaTech_USA,45
CS4784,1,2022,24,30,,VirginiaTech_USA,54
CS4804,1,2020,6,42,,VirginiaTech_USA,48
CS4804,1,2021,3,63,,VirginiaTech_USA,66
CS4804,1,2022,3,54,,VirginiaTech_USA,57
